RD,TS_received,TS_sent,AK,RoundTrip,
341084,341092,2019-11-27_11-19-14-685570,341095,8,
346192,346368,2019-11-27_11-19-20-882697,346372,176,
351300,351339,2019-11-27_11-19-26-865352,351342,39,
356408,356417,2019-11-27_11-19-32-914732,356420,9,
361516,361523,2019-11-27_11-19-38-993241,361528,7,
366624,366633,2019-11-27_11-19-45-068895,366638,9,
371732,371740,2019-11-27_11-19-51-145719,371744,8,
376840,376846,2019-11-27_11-19-57-213710,376849,6,
381948,381954,2019-11-27_11-20-03-284787,381957,6,
387056,387062,2019-11-27_11-20-09-356163,387066,6,
392164,392170,2019-11-27_11-20-15-439235,392174,6,
397272,397280,2019-11-27_11-20-21-500779,397285,8,
402380,402387,2019-11-27_11-20-27-583059,402390,7,
407488,407500,2019-11-27_11-20-33-669525,407503,12,
412596,412767,2019-11-27_11-20-39-848178,412770,171,
417704,417769,2019-11-27_11-20-45-874320,417772,65,
422812,422818,2019-11-27_11-20-51-879797,422824,6,
427920,427928,2019-11-27_11-20-57-963712,427931,8,
433028,433041,2019-11-27_11-21-04-062856,433045,13,
438136,438143,2019-11-27_11-21-10-133196,438148,7,
443244,443253,2019-11-27_11-21-16-201787,443256,9,
448352,448359,2019-11-27_11-21-22-262518,448363,7,
453460,453466,2019-11-27_11-21-28-334776,453470,6,
458568,458603,2019-11-27_11-21-34-434251,458606,35,
463676,463683,2019-11-27_11-21-40-480154,463686,7,
468784,468791,2019-11-27_11-21-46-562898,468794,7,
473892,473898,2019-11-27_11-21-52-639967,473902,6,
479000,479009,2019-11-27_11-21-58-703788,479011,9,
484108,484204,2019-11-27_11-22-04-883024,484207,96,
489216,489239,2019-11-27_11-22-10-868794,489242,23,
494324,494334,2019-11-27_11-22-16-922462,494337,10,
499432,499440,2019-11-27_11-22-23-000459,499443,8,
504540,504549,2019-11-27_11-22-29-075793,504552,9,
509648,509654,2019-11-27_11-22-35-151065,509657,6,
514756,514763,2019-11-27_11-22-41-228499,514766,7,
519864,519872,2019-11-27_11-22-47-299674,519875,8,
524972,525021,2019-11-27_11-22-53-404056,525025,49,
530080,530108,2019-11-27_11-22-59-472585,530111,28,
535188,535195,2019-11-27_11-23-05-523472,535198,7,
540296,540302,2019-11-27_11-23-11-589355,540306,6,
545404,545409,2019-11-27_11-23-17-661596,545412,5,
550512,550680,2019-11-27_11-23-23-873121,550683,168,
555620,555637,2019-11-27_11-23-29-840788,555640,17,
560728,560735,2019-11-27_11-23-35-914614,560738,7,
565836,565843,2019-11-27_11-23-41-989533,565847,7,
570944,571298,2019-11-27_11-23-48-445141,571303,354,
576052,576062,2019-11-27_11-23-54-135604,576063,10,
581160,581167,2019-11-27_11-24-00-200115,581170,7,
586268,586275,2019-11-27_11-24-06-269723,586278,7,
591376,591383,2019-11-27_11-24-12-346608,591387,7,
596484,596490,2019-11-27_11-24-18-427828,596493,6,
601592,601599,2019-11-27_11-24-24-498353,601602,7,
606700,606706,2019-11-27_11-24-30-560297,606709,6,
611808,611816,2019-11-27_11-24-36-629857,611819,8,
616916,616930,2019-11-27_11-24-42-698146,616933,14,
622024,622089,2019-11-27_11-24-48-846134,622090,65,
627132,627140,2019-11-27_11-24-54-856956,627144,8,
632240,632247,2019-11-27_11-25-00-927410,632250,7,
637348,637353,2019-11-27_11-25-06-995601,637356,5,
642456,642500,2019-11-27_11-25-13-117180,642503,44,
647564,647578,2019-11-27_11-25-19-150511,647581,14,
652672,652708,2019-11-27_11-25-25-245450,652711,36,
657780,657791,2019-11-27_11-25-31-286494,657795,11,
662888,662899,2019-11-27_11-25-37-370851,662902,11,
667996,668005,2019-11-27_11-25-43-466175,668010,9,
673104,673128,2019-11-27_11-25-49-522295,673133,24,
678212,678220,2019-11-27_11-25-55-597025,678223,8,
683320,683326,2019-11-27_11-26-01-673809,683329,6,
688428,688598,2019-11-27_11-26-07-875843,688601,170,
693536,693566,2019-11-27_11-26-13-849704,693570,30,
698644,698652,2019-11-27_11-26-19-912802,698655,8,
703752,703760,2019-11-27_11-26-25-981662,703764,8,
708860,708869,2019-11-27_11-26-32-043729,708871,9,
713968,714046,2019-11-27_11-26-38-211723,714049,78,
719076,719082,2019-11-27_11-26-44-202236,719087,6,
724184,724251,2019-11-27_11-26-50-332915,724254,67,
729292,729299,2019-11-27_11-26-56-352943,729302,7,
734400,734405,2019-11-27_11-27-02-415905,734408,5,
739508,739514,2019-11-27_11-27-08-492090,739517,6,
744616,744621,2019-11-27_11-27-14-588361,744625,5,
749724,749731,2019-11-27_11-27-20-671715,749734,7,
754832,754913,2019-11-27_11-27-26-838397,754916,81,
759940,759982,2019-11-27_11-27-32-858112,759986,42,
765048,765058,2019-11-27_11-27-38-885431,765061,10,
770156,770163,2019-11-27_11-27-44-981736,770168,7,
775264,775269,2019-11-27_11-27-51-051618,775272,5,
780372,780379,2019-11-27_11-27-57-136058,780382,7,
785480,785489,2019-11-27_11-28-03-205122,785490,9,
790588,790593,2019-11-27_11-28-09-269298,790596,5,
795696,795704,2019-11-27_11-28-15-342081,795709,8,
800804,800811,2019-11-27_11-28-21-409270,800814,7,
805912,805919,2019-11-27_11-28-27-495988,805922,7,
811020,811026,2019-11-27_11-28-33-553277,811030,6,
816128,816134,2019-11-27_11-28-39-622956,816137,6,
821571,821578,2019-11-27_11-28-46-091134,821581,7,
828752,828765,2019-11-27_11-28-54-518394,828769,13,
833900,833907,2019-11-27_11-29-00-667353,833910,7,
839007,839102,2019-11-27_11-29-06-844865,839106,95,
844115,844147,2019-11-27_11-29-12-836344,844150,32,
849223,849243,2019-11-27_11-29-18-874310,849247,20,