RD,TS_received,TS_sent,AK,RoundTrip,
38666,38678,2019-12-16_13-50-06-233621,38682,12,
43774,43786,2019-12-16_13-50-12-320198,43789,12,
48882,48889,2019-12-16_13-50-18-384944,48892,7,
53990,54146,2019-12-16_13-50-24-621884,54149,156,
59098,59126,2019-12-16_13-50-30-561217,59129,28,
64206,64221,2019-12-16_13-50-36-586117,64224,15,
69314,69321,2019-12-16_13-50-42-644165,69324,7,
74422,74428,2019-12-16_13-50-48-753667,74431,6,
79530,79537,2019-12-16_13-50-54-815865,79540,7,
84638,84645,2019-12-16_13-51-00-866225,84650,7,
89746,89766,2019-12-16_13-51-06-901283,89771,20,
94854,94863,2019-12-16_13-51-12-942849,94867,9,
99962,99971,2019-12-16_13-51-19-021584,99972,9,
105070,105077,2019-12-16_13-51-25-059710,105081,7,
110178,110186,2019-12-16_13-51-31-141200,110189,8,
115286,115303,2019-12-16_13-51-37-257422,115307,17,
120394,120400,2019-12-16_13-51-43-340083,120403,6,
125502,125510,2019-12-16_13-51-49-432920,125513,8,
130610,130767,2019-12-16_13-51-55-692646,130770,157,
135718,135726,2019-12-16_13-52-01-651740,135729,8,
140826,140833,2019-12-16_13-52-07-767798,140837,7,
145934,145941,2019-12-16_13-52-13-838095,145944,7,
151042,151051,2019-12-16_13-52-19-939405,151054,9,
156150,156157,2019-12-16_13-52-26-036097,156161,7,
161258,161264,2019-12-16_13-52-32-136819,161269,6,
166366,166373,2019-12-16_13-52-38-222165,166377,7,
171474,171479,2019-12-16_13-52-44-307249,171484,5,
176582,176590,2019-12-16_13-52-50-356447,176594,8,
181690,181696,2019-12-16_13-52-56-407811,181700,6,
186798,186965,2019-12-16_13-53-02-593195,186966,167,
191906,191969,2019-12-16_13-53-08-563840,191974,63,
197014,197057,2019-12-16_13-53-14-567789,197060,43,
202122,202131,2019-12-16_13-53-20-579617,202134,9,
207230,207239,2019-12-16_13-53-26-653240,207242,9,
212338,212348,2019-12-16_13-53-32-690712,212351,10,
217446,217456,2019-12-16_13-53-38-713915,217459,10,
222554,222560,2019-12-16_13-53-44-758627,222563,6,
227662,227668,2019-12-16_13-53-50-784275,227671,6,
232770,232776,2019-12-16_13-53-56-833040,232781,6,
237878,237885,2019-12-16_13-54-02-908024,237888,7,
242986,242994,2019-12-16_13-54-09-008129,242998,8,
248094,248102,2019-12-16_13-54-15-103761,248106,8,
253202,253209,2019-12-16_13-54-21-179469,253212,7,
258310,258317,2019-12-16_13-54-27-271190,258320,7,
263418,263425,2019-12-16_13-54-33-358126,263428,7,
268526,268628,2019-12-16_13-54-39-566370,268688,102,
273634,273655,2019-12-16_13-54-45-563975,273658,21,
278742,278750,2019-12-16_13-54-51-674653,278754,8,
283850,283886,2019-12-16_13-54-57-791547,283889,36,
288958,288962,2019-12-16_13-55-03-809374,288967,4,
294066,294085,2019-12-16_13-55-09-877531,294088,19,
299174,299179,2019-12-16_13-55-15-916522,299182,5,
304282,304290,2019-12-16_13-55-22-019249,304295,8,
309390,309396,2019-12-16_13-55-28-114293,309399,6,
314498,314504,2019-12-16_13-55-34-180243,314507,6,
319606,319614,2019-12-16_13-55-40-227782,319617,8,
324714,324721,2019-12-16_13-55-46-271960,324725,7,
329822,329828,2019-12-16_13-55-52-360283,329831,6,
334930,335087,2019-12-16_13-55-58-574390,335090,157,
340038,340117,2019-12-16_13-56-04-576391,340120,79,
345146,345185,2019-12-16_13-56-10-567498,345188,39,
350254,350261,2019-12-16_13-56-16-593184,350265,7,
355362,355374,2019-12-16_13-56-22-656785,355377,12,
360470,360478,2019-12-16_13-56-28-757611,360481,8,
365578,365585,2019-12-16_13-56-34-848358,365588,7,
370686,370693,2019-12-16_13-56-40-969758,370697,7,
375794,375874,2019-12-16_13-56-47-166544,375877,80,
380902,380909,2019-12-16_13-56-53-130644,380912,7,
386010,386015,2019-12-16_13-56-59-170408,386018,5,
391118,391127,2019-12-16_13-57-05-241126,391130,9,
396226,396233,2019-12-16_13-57-11-330727,396236,7,
401334,401341,2019-12-16_13-57-17-422069,401345,7,
406442,406504,2019-12-16_13-57-23-549698,406507,62,
411550,411601,2019-12-16_13-57-29-583021,411605,51,
416658,416668,2019-12-16_13-57-35-559554,416671,10,
421785,421792,2019-12-16_13-57-41-675340,421796,7,
426893,426899,2019-12-16_13-57-47-750949,426902,6,
432001,432007,2019-12-16_13-57-53-805624,432010,6,
437109,437115,2019-12-16_13-57-59-863427,437119,6,
442217,442230,2019-12-16_13-58-05-929609,442233,13,
447325,447332,2019-12-16_13-58-11-995460,447335,7,
452433,452441,2019-12-16_13-58-18-061152,452444,8,
457541,457549,2019-12-16_13-58-24-137280,457553,8,
462649,462656,2019-12-16_13-58-30-180853,462661,7,
467757,467765,2019-12-16_13-58-36-252033,467768,8,
472865,472872,2019-12-16_13-58-42-324999,472875,7,
477973,478001,2019-12-16_13-58-48-421330,478004,28,
483081,483247,2019-12-16_13-58-54-639531,483251,166,
488189,488200,2019-12-16_13-59-00-568967,488204,11,
493297,493304,2019-12-16_13-59-06-662845,493309,7,
498405,498416,2019-12-16_13-59-12-728555,498419,11,
503513,503521,2019-12-16_13-59-18-815846,503526,8,
508621,508632,2019-12-16_13-59-24-875923,508635,11,
513729,513739,2019-12-16_13-59-30-964330,513742,10,
518837,518844,2019-12-16_13-59-37-082960,518849,7,
523945,523954,2019-12-16_13-59-43-190845,523958,9,
529053,529059,2019-12-16_13-59-49-297493,529062,6,
534161,534167,2019-12-16_13-59-55-397305,534170,6,
539269,539316,2019-12-16_14-00-01-541539,539319,47,
544377,544398,2019-12-16_14-00-07-561734,544401,21,
549485,549491,2019-12-16_14-00-13-633451,549495,6,
554593,554598,2019-12-16_14-00-19-667565,554601,5,